SO  ./bonus/TEXTURE/mossy.xpm
NO  ./bonus/TEXTURE/eagle.xpm
WE  ./bonus/TEXTURE/greystone.xpm
EA ./bonus/TEXTURE/purplestone.xpm
F               0,  0,0
C   225,255,                            0












         111111111111111111111111
         1000000000110000000000001
         1011000001110000000000001
         1001000000000000000000001
111111111011000001110000000000001
100000000011000001110111111111111
11110111111111010000000010001
11110111111111011101010010001
11000000110101011100000010001
10000000000000001100000000001
1000000000000001101010010111
1100000111010101111101111 N0111
11110111 1110101 101111011001
11111111 1111111 111111111111